          ############
      ####################
    ########################
  ####  ####  ####  ####  ####
################################
    ######    ####    ######
      ##                ##